[MAP]
{
Cabane
fight_background.png
10
10
4
9
Up
024024028028028028028033033033
028028028028028028028028028028
028028028028028028028028028028
028028028028028028028028028028
028028028028029030028028028028
028028028028031032028028028028
028028028028028028028028028028
028028028028028028028028028028
028028028028028028028028028028
028028028028028028028028028028
}
[PNJ]
{
Skipulysse
Cthulhu.png
empty.txt
1
1
}