[MAP]
{
Cabanon
fight_background.png
14
13
0
6
Right
015015015015015015015015015015015015015015
300300001001001001001420421422001001001015
300001001001001001001423424425001001001015
001001001001001001001426427428001001001015
001001001001001001001001001001001001001015
001001001001001001001001001001001001001015
004004004004004004004004004008001001017015
001001001001001001001001001005004004017017
001001001001001001001001001001001001017017
001001001001001001001001001001001001001015
001001001001001001001300001001001001001015
001001001001001001001001001001001001001015
015015015015015015015015015015015015015015
}
[TRIGGER]
{
LOAD:Cabane.level
8
4
}