[MAP]
{
DML1
fight_forest.jpg
10
10
4
9
Up
002002002002009002002002002002
061002002002009002002018002002
002018018013012002002002018002
002013010012061002002061061002
002009002002002002002002002002
002009002002018018002002002002
002011014002002061002002018002
002002009002002002002002018002
002002011010014061002002002002
061061002002009061002002002002
061002002002009002002018002018
002002002002009002002002002061
}
[TRIGGER]
{
LOAD:DML2.level
4
0
}