[MAP]
{
DML2
fight_forest.jpg
10
10
0
4
Right
002002002002002002002002002009
002002002002002002002013010012
002002018002002002002009002002
002002002002002013010012002002
010010010014061009002002002002
002002002011010012002002002002
002002002002002002002018002002
002002002002002002002002018002
002002002018002002002002018002
002061061002002002002002002061
002002018002002002002002002002
002002002002002002002002061061
}
[TRIGGER]
{
LOAD:pantoufle.level
9
0
}
