[MAP]
{
foret brulee
fight_background.png
15
15
0
5
Up
038038038038038038018002038002039039038038038
038038038002039002002002039039038002039038038
038038038002002002002039002039039002002002038
038038002002002002002002039002002002002038038
002002002002002002002002002002002002002038038
002002002002002002002038039002018002039002038
038038002002039002038002038002002039002038038
038038002002002002039038018002002002038039002
038038002002002002002002002002038038002002002
038002002002038038038038038038038002002002038
038038002038038002039002038038002002038002038
038002002002002039039039002038002038038038038
038038002038038002039002038002002038039038038
038038002002002002002002002002038038038002038
038038018038038038039038038038038038038002038
}
[TRIGGER]
{
LOAD:village.level
14
8
}
