[MAP]
{
TEST
fight_background.png
12
12
3
3
015015015001015001015001001015001015
001015015001015001015015001001001015
015015015015015001001001001001015015
015015015015015001015001001001015015
015015015001001015015001001001001015
015015001001001015001001001001001001
015001001015015015001001001001001001
001001001001001001001001001001001001
001001001001001001001001001001001001
001001001001001001001001001001001001
001001001001001001001001001001001001
001001001001001001001001001001001001
}

[TRIGGER]
{
LOAD:test2.level
0
3
}
