[MAP]
{
TEST
fight_background.png
12
12
3
3
015015015003015001015001001015001015
015015015005004008015015001001001015
015015015015015003015001001001015015
015015015015015003015001015001015015
015015015001007006015001015001015015
015015007004006015001001015001001001
015001003015015015001015015015015001
007004006001001015015001001015001001
003015015015001001001001001001001001
003001015015015015015001001001001001
003015015015015015015001015015015015
003015015015015015015001001015015015
}

[TRIGGER]
{
LOAD:TEST.level
0
12
}
