[MAP]
{
GML1
fight_forest.jpg
10
10
4
0
Down
016001001001003001001001016016
017017001001005008001001001015
017001001001001003001017015001
017001001015001003017017001001
001001001015001003001001015001
001001001001001005004004008015
001007004008001001017017003015
004006001003015001001017003001
001001001005004004004004006001
016001001001001001001001001001
016016001001001001001016001001
016001001001001001016016001001
}
[TRIGGER]
{
LOAD:GML2.level
0
7
}