[MAP]
{
GML2
fight_forest.jpg
10
10
5
0
Down
001001015015001003017001001001
001001015001001003001001001016
001001001001001005008001016001
001001001001001016003001016001
001015017001001016003001001001
001017001001007004059008001001
001001017001003001001005004004
001001001001003001001017001001
001001007004006001015015001001
001001003001001001015001001001
001001055001001015001001016016
015001017001001001001001001016
}
[TRIGGER]
{
LOAD:MAPLABY.level
9
6
}
