[MAP]
{
MAPLABY.level
fight_background.png
20
20
1
19
Up
016016007052016016054016016016016054016007004004008016016016
054016003016007004057016007004056059056006016016003016007004
003016003016003016005004006016003016003016016016003016003016
005004057016003016016016016016003016005004004004059004057016
016016003016058004004004052016003016016016016016016016003016
016016005004057016016016016016058004004004008016007004006016
016016016016058052016054016016003016016016003016003016016016
054016007004057016016003016007006016007004006016003016007004
003016003016005004056059004006016016003016016016005004057016
003016003016016016003016016016016016005052016016016016003016
005056006016053004059056052016007052016016016007052016055016
016003016016016016016003016016003016007052016003016016016016
016005008016016016016005004004057016003016016058004008016016
016016058052016054016016016016003016003016007006016005004008
016053006016016003016007052016058004057016003016016016016003
016016016007004059004057016016003016003016005052016007004006
007004004057016016016005008016003016003016016016016003016016
003016016003016016016016005004057016005056004056004057016054
003016016005004004004008016016005052016003016003016005056006
005004008016016016016005052016016016016005004006016016055016
}
[TRIGGER]
{
LOAD:mapsuivante.level
19
7
}
[TRIGGER]
{
LOAD:mapprécédente.level
2
19
}
