[MAP]
{
Prison
fight_forest.jpg
27
29
25
26
Up
403403403403403403403403403403403403403403403403403403403403403403403403403403403
403404404404403404404404403404404404403404404404403404404404404404404404404404403
403404404404403404404404403404404404403404404404403404404404404404404404404404403
403404404404403404404404403404404404403404404404403404404404404404404404404404403
403404404404403404404404403404404404403404404404403404404404404404404404404404403
403403403404403403403404403403403404403404404404403403403403403404403403403403403
403404404404404404404404404404404404404404404404404404404404404404404404404404403
403404404404404404404404404404404404404404404404404404404404404404404404404404403
403404404404404404404404404404404404404404404404404404404404404404404404404404403
403404404404403403403403403403403404404404403403403403403403403403403404404404403
403404404404403404404404404404403404404404403404404404404404404404403404404404403
403404404404403404404404404404403404404404403404404404404404404404404404404404403
403404404404404404404404404404403404404404403404404404404404404404403404404404403
403404404404403403403403403403403404404404403404404404404404404404403404404404403
403404404404403404404404404404403404404404403404404404404404404404403404404404403
403404404404403404404404404404403404404404403404404404404404404404403404404404403
403404404404403404404404404404403404404404404404404404404404404404403404404404403
403404404404404404404404404404403404404404403404404404404404404404403404404404403
403404404404403403403403403403403404404404403403403403403403403403403404404404403
403404404404403404404404404404403404404404404404404404404404404404404404404404403
403404404404403404404404404404403404404404404404404404404404404404404404404404403
403404404404403404404404404404403404404404404404404404404404404404404404404404403
403404404404404404404404404404403404403403403404403403403404403403403404404404403
403404404404403403403403403403403404404404403404404404403404404404403404404404403
403404404404403404404404404404403404404404403404404404403404404404403404404404403
403404404404403404404405406407403404404404403404404404403404404404403404404404403
403404404404403404404408409410403404404404403404404404403404404404403404404404403
403404404404404404404411412413403404404404403404404404403404404404403404404404403
403403403403403403403403403403403403403403403403403403403403403403403403403403403
}
[PNJ]
{
Web
Web.png
empty.txt
25
6
}
[PNJ]
{
Web
Web.png
empty.txt
18
1
}
[PNJ]
{
Web
Web.png
empty.txt
18
2
}
[PNJ]
{
Web
Web.png
empty.txt
17
4
}
[PNJ]
{
Web
Web.png
empty.txt
18
4
}
[PNJ]
{
Web
Web.png
empty.txt
19
4
}
[PNJ]
{
Web
Web.png
empty.txt
20
4
}
[PNJ]
{
Web
Web.png
empty.txt
20
3
}
[PNJ]
{
Web
Web.png
empty.txt
20
2
}
[PNJ]
{
Web
Web.png
empty.txt
21
2
}
[PNJ]
{
Web
Web.png
empty.txt
22
2
}
[PNJ]
{
Web
Web.png
empty.txt
23
2
}
[PNJ]
{
Web
Web.png
empty.txt
24
2
}