[MAP]
{
SML2
fight_forest.jpg
19
19
9
9
Up
403403403403403403403403403403403403403403403403403403403
403062063404404404403063404404404404403404404062404404403
403063405406407404403404404404404062403404404404404404403
403404408409410404403404404404404062403404404404404404403
403404411412413404403404404404404404403063404404404404403
403404404404404404403404404404404404403063404404404404403
403403403404403403403403403404403403403403403404403403403
403404404404404404403062062404404063403404404404404404403
403404404404404404403404405406407404403404404404404404403
403063404404404404404404408409410404404404404404404404403
403063062404404404403404411412413404403063404404404404403
403404404404404404403404062404404063403404404404063062403
403403403404403403403403403404403403403403403404403403403
403404063404404063403404404404404062403404404404404404403
403404404404404404403404404404404062403404404404404404403
403404404062404404403404404404404063403404063404404404403
403404404404404404403404404404404404403062404404404404403
403404404404404404403063404404404404403062404404404063403
403403403403403403403403403403403403403403403403403403403
}

[TRIGGER]
{
LOAD:DML2.level
3
3
}