[MAP]
{
DML1
fight_forest.jpg
19
18
9
17
Up
065065065065065065065065065065065065065065065065065065065
065064064064064064064064064064064064064064064064064064065
065064064071064064064071064064064068064064064068064064065
065064071064071064064064064074064064064064068064068064065
065064064064064064064064064073064064064064064064064064065
065064064064064064064069064064064070064064064064064064065
065064064064064064064064064064064064064064064064064064065
065064064064064064072064064064064064072064064064064064065
065064064064064064072064064064064064072064064064064064065
065064064064064064072064064064064064072064064064064064065
065064064064064064072064064064064064072064064064064064065
065064064064064064072064064064064064072064064064064064065
065064064064064072066064064064064064067072064064064064065
065064064064064064064064064064064064064064064064064064065
065064069064069064064064064064064064064064070064070064065
065064064069064064064064064064064064064064064070064064065
065064064064064064064064064064064064064064064064064064065
065065065065065065065065065064065065065065065065065065065
]