[MAP]
{
TEST
fight_forest.jpg
12
12
3
3
Up
001001001001001001001001001001001001
001001001001001001001001001001001001
001001001001001001001001001001001001
001001001001001001001001001001001001
001001001001001000001000001001001001
001001001001001001001001001001001001
001001001001001001001001001001001001
001001001001001001001001001001001001
001001001001001001001001001001001001
001001001001001001001001001001001001
001001001001001001001001001001001001
001001001001001001001001001001001400
}
[TRIGGER]
{
LOAD:foret brulee.level
0
0
}
[TRIGGER]
{
LOAD:village.level
1
0
}
[TRIGGER]
{
LOAD:V2.level
2
0
}
[TRIGGER]
{
LOAD:Cabane.level
3
0
}
