[MAP]
{
V2
fight_forest.jpg
16
17
0
8
Right
002002018002002002301301420421422018002420421422
420421422018002002002002423424425018002423424425
423424425018002002002061426427428002002426427428
426427428002002420421422061420421422002002018301
301301420421422423424425002423424425002018018301
002301423424425426427428002426427428002002002301
002002426427428061061002002301301002002002002002
002002002002002002018002002301002002002301002002
010010010010014002002002002002002002420421422002
002002002002011014002002420421422002423424425002
420421422002002009002002423424425018426427428002
423424425301002011014002426427428061061301018002
426427428301301002009002301420421422002002018002
061420421422002002009002002423424425002002002002
002423424425002002011014002426427428002420421422
002426427428002002002009002018061002002423424425
002002002002002002002009002018002002002426427428
}
[TRIGGER]
{
LOAD:DML1.level
7
16
}
