[MAP]
{
VILLAGE
fight_background.png
18
18
0
16
Right
019020021019020021009019020021019020021019020021001015
022023024022023024009022023024022023024022023024015035
025026027025026027009025026027025026027025026027001015
019020021035001001001001001001001035035001001001001001
022023024001013010010010010010010010010010010010010010
025026027001009001001001001001001001001009001001015015
010010010001009001001001001001001001001009001001001001
019020021001009001001001001001001001001009001001001001
022023024001009001001001001001001001001009035019020021
025026027001009010010010010010010010010012035022023024
019020021001009001001001035035001001035001035025026027
022023024001009001019020021019020021019020021019020021
025026027001009001022023024022023024022023024022023024
001001001035009001025026027025026027025026027025026027
015015001001009001001001001001001001001001001001001001
015001035015009001019020021019020021019020021019020021
010010010010012001022023024022023024022023024022023024
015015015015035001025026027025026027025026027025026027

}